type square
height 14
width 21
map
@@@@@@@@@@@@@@@@@@@@@
@...................@
@.@@@@@@@@@@@@@@@@@.@
@...................@
@...................@
@...................@
@...................@
@...................@
@...................@
@...................@
@...................@
@...................@
@@@@@@@@@@.@@@@@@@@@@
@@@@@@@@@@@@@@@@@@@@@